{
  "0": "a",
  "1": "b",
  "2": "c",
  "3": "d",
  "4": "e",
  "5": "f",
  "6": "g",
  "7": "h",
  "8": "i",
  "9": "a",
  "10": "b",
  "11": "c",
  "12": "d",
  "13": "e",
  "14": "f",
  "15": "g",
  "16": "h",
  "17": "i",
  "18": "a",
  "19": "b",
  "20": "c",
  "21": "d",
  "22": "e",
  "23": "f",
  "24": "g",
  "25": "h",
  "26": "i",
  "27": "a",
  "28": "b",
  "29": "c",
  "30": "d",
  "31": "e",
  "32": "f",
  "33": "g",
  "34": "h",
  "35": "i",
  "36": "a",
  "37": "b",
  "38": "c",
  "39": "d",
  "40": "e",
  "41": "f",
  "42": "g",
  "43": "h"
}